1111111111
1101100111
1101111311
1101131111
1111111111
1110011111
1113001111
1111110111
1130001111
1111111115
